 ##### ##### ### ############# #########
#.....#.....#...#.............#.........#
 ##.#.###.#.#.#.#.#####.#####.###.#####.#
#...#...#.#...#.#.#...#.#.....#...#.....#
#.#####.#.#.#####.#.#.#.#.#####.###.####
#.#...#...#.#...#...#.#.#.....#...#.#...#
#.#.#.#######.#.#####.#.#####.###.#.###.#
#...#.........#.......#.....#.....#...#.#
#.## ######################.###### ##.#.#
#...#.....#.....#.#.......#...#...#...#.#
 ##.#.###.#.###.#.#.#####.###.#.#.#.###.#
#...#...#...#.#...#.#...#...#.#.#...#...#
#.#####.#####.###.#.###.###.#.#.#######.#
#.......#...#.....#...#.......#...#.....#
 ########.#.#.#### ##.###.#######.###.##
#...#.....#.#.#...#.#...#.#.....#...#...#
#.###.#####.#.#.#.#.###.###.###.###.###.#
#.....#.#...#...#.....#.....#.#.#.......#
#.#####.#.###########.#######.#.#######.#
#.#.....#.........#.......#...#.....#...#
#.#.###.#####.#.###.#####.###.#####.####
#...#...#...#.#.#...#...#.........#.#...#
 ####.###.#.#.###.#####.###.#######.#.#.#
#.....#...#.#.........#.#...#.......#.#.#
#.#####.###.###########.#.###.#####.#.#.#
#...#...#.#.............#.#...#.....#.#.#
 ##.#.###.#################.#.#######.#.#
#.#.#...#...#.......#.....#.#.#.....#.#.#
#.#.###.#.#.#.#####.###.#.#.#.#.###.#.#.#
#...#...#.#...#...#.#...#...#.#...#...#.#
#.###.###.#####.###.#.###########.#####.#
#...#.#.....#...#...#.............#...#.#
 ##.#.#####.#.#.#.###.#########.###.#.#.#
#...#.....#.#.#.#.#...#.......#.....#o#.#
#.#######.#.#.#.#.#####.#####.###### ##.#
#.....#.#...#.#...#.....#...#...#...#...#
 ####.#.#####.#####.#####.#.###.#.#.#.##
#...#.....#...#...#.....#.#...#...#.#...#
#.#.#####.#.###.#.#####.#.###.#####.###.#
#.#.......#.....#.......#...#...........#
 # ####### ##### ####### ### ###########
